

                         ###############################################
                         #                   TUTORIAL                  #
                         ###############################################
                         #                                             #
                         #                                             #
                         #                                             #
                         #                                             #
                         #                                             #
                         #                                             #
                         #                                             #
                         #                                             #
                         #                                             #
                         #                                             #
                         #                                             #
                         ###############################################