########################################
#               TUTORIAL               #   
########################################
#        ###                 ###########         
#        ###                 ##### #####
#        # #                 ##### #####
#          #                         ###
#                                      #
########################################
               #         #
               #         #
               #         #
               ###########