



                        ########################################################
                        #                                                      #
                        ########################################################
             ############                                                      #
             #                                                                 # 
             #                                                                 #
             #                                                                 # 
             #                                                                 #
             #                                                                 #
             #                                                                 #
             ############################################### ###################
             #           #          #          #          #      #
             #           #          #          #          #      #
             #           #          #          #          ########
             #           #          #          #
             ###################################