



                             
                             #############################################                                             ###          ###  
                             #                                           #                                             # #          # # 
                             #############################################                                             # #          # #
                             #                                           #                                             # ############ #  
                             #                                           #                                             #              # 
                             #                                           #                                             #              # 
                             #                                           #                              ################ ############ ############
                             ######## ######################## ###########                              #                               #        #
                                    # #        #          #  # #                                        #                               #        #
                                    # #        #          #  # #                                        #                                        #
                                    ###        ############  ###                                        #                               #        #
                                                                                                        #                               #        #
                                                                                                        ########################################## 
                         
                                  


                                       ####################################################
                                       #                                                  #
                                       #                                                  #
                                       #                                                  #
                                       #                                                  #
                                       #                                                  #
                                       #                                                  #
                                       ####################################################