



                           ######################################################## 
                           #                                                      #      
                           ########################################################               
                           #                                                      #
                           #                                                      #
                           #                                                      # 
                           #                                                      # 
                           #                                                      #
                           #         #              ###                     #######
                           #                          #   #                 #     #
                           #                        ###      #                    #
                           #                                                #######
                           #                                                      #
                           #                                                      #  
                           #                                                      # 
                           #                                                      #
                           ########################################################
                                           #           #               #
                                           #           #               #
                                           #           #               #
                                           #############################    