



           ##################################################################           
           #                                                                #
           ##################################################################              
           #                                                                # 
           #                                                                #
           #                                                                #
           #                                                                # 
           #                                                                #
           #                                                                #
           #                                                                #
           #                                                                #
           #                                                                #
           ##################################################################
                       #                  #                  #
                       #                  #                  #
                       #                  #                  #
                       #                  #                  #
                       #                  #                  #   
                       #######################################
                       #                  #                  #
                       #######################################       