


                         ###########################################################
                         #                                                         # 
                         ###########################################################
               ###########           #                                 #           #
               #         #           #                                 #           #
               #         #           #                                 #           #
               #         #           #                                 #           #
               ###########                                             #           #
               #         #           #                                             #
               #         #           #                                 #           #
               #         #           #                                 #           #
               #####################################################################