



                                            ###########################################################################
                                            #                                                                         #
                                            #                                                                         #
                                            #                                                                         #
                                            #                                                                         # 
                                            #                                                                         #
                                            #                                                                         # 
                                            #                                                                         #
                                            #                                                                         #
                                            #                                                                         #
                                            #                                                                         #  
                                            #                                                                         #
                                            #                                                                         #
                                            #                                                                         #
                                            #                                                                         #
                                            #                                                                         # 
                                            #                                                                         #
                                            #                                                                         #
                                            #                                                                         #
                                            #                                                                         # 
                                            #                                                                         #
                                            #                                                                         # 
                                            #                                                                         #  
                                            #                                                                         #
                                            #                                                                         #
                                            ###########################################################################
