





                        ##########################################################################
                        #      #                 #                                               #
                        #                                                                        #
                        #      #                               #                                 #######
                        ########################################                                       # 
                        #    #######                                                             #     #
                        #             ############ ######### #############################################
                 #########                       ###       ###                                           #                               ##########
                 #       #                                                                               #                               #        # 
                 #       #                                                                               #                               #        #     
                 #       #                                                                               #################################        #
                 #                                                                                       #                         #              ###
                 ####### #############################################################################   #                         3                #
                    #                                                                                                           ##################### 
                    #                                                                                                           #  
                    #                                                                                                           #
                    #         #######################################                                                           # 
        #############                                               ###############                                             #
        #                                                           #             ###############################################
        #                                                           # 
        #                                                           #
        ##############################################              #  
                                                     #              ######
                                                     #                   #
                                                     ##################### 