

                                                            ##########################################
                                                            #                                        #
                                                            #                                        #  
                                            #################   ##################                   #             
                                            #   #                                #                   #
                                            #                   #                #                   #
                        #####################       ######################       #                   #
                        #                                                #       #                   #  
                        #                                                #       #####################
                        #                                                #       #
                #####################################                    #       #
                #  #                                #                    #       #
                #                                   #                    #       #
                ####                                #                    #       #
                   #                                ##################   #       #
                   #                                                             # 
                 ###                                ##############################
                 #                                  #
                 #                                  #
                 ########                           #
                        ##############   ############ 
                                #               #
                                #               #
                                #               #
                                #               #  
                                #               # 
                                #               #
                                ################# 