
                                  ############################
                                  #                          #
                                  #                          #
                                  #                          ##############
               ############################### ###############################                #######
     ###########                                                             #####            #     #
     #                                                                           ## ###########     #
     #         #                                                                  ###       ##### #############
     # #      ##                                #                           #                                 #
     #     #################################################################################################### 
     #     #                                                        #                               #
     #     #                                                                                        #
     #   # #                                                                                        #  
     #     #                                                                                        ###########
     #     #                                                                                                  #
     #     ##################################################################################### #################  
     ##            ####                                                              #                           #      
     #                #                                                                                #         #      
     #                ###############                                                                            #
     #                     #                                                                                     # 
     #                     #                                                                                     # 
     #                     ##### ##########                                                               ##### ##########  
     #    #                               #                                                   #############  #           #
     #          #                         ####################                                         #    ##           #
     ######################################                  ################                 #        #    #            #
                                                                            ############################    ##############           