                                           
                                                ###
      ########################################### ###
      #                                             ######################################################## 
      #    #          # ######## ########## #########                                                      #       
      #               # #      # #        # #       ##                                                     #
      #    #          ###      ###        ###        ##                                                    #
      #    #         ##                               #######################################              #
      #    ###########                                                                 #    #              #####
      #                                                                                #    #                  #
      #                                                                                #    #              #####
      #                                                                                     #              #
      ################################       ###########################   ##################              #
                                     #                                 #                                   #
                           ###########       ###############################################################
                           #                                           #
                           #                                           #
                           #                                           #
                           #                                           #
                           #                                           #
                           ######################################      #
                                                                #      #
                                                                #      #
                                                                #      #
                                               ##################      #
                                               #                       #
                                               #                       #
                                               #                       #
                                               #######  ################    
                                               #        #
                                               #        #  
                                               ##########  