





                                  
                                                               ###########################  
                                                            ####                         #                               #####
                                                            #  #                      ####                               #   ####
                                                            #  #                      #                                  #      #
                                                            #  #                      #                           ########   ###########################
                                                            #                         #                           #                            #       #
                     ######################################## #########################                           #                            #       #
                     #                                        #                                                   #                            #       #  
                     #                                        #                                                   #                            ######  #
                     #                                        #                                                   #                                    # 
                     ##### ################################## ###########                                         #                                    #
                         # #                                #           #                                         #                                    #
                         # #                                # #####################################################                                    #
                         ###                                #  #                     #                            #                                    #
                                                            #  #                              #                   #                                    #
                                                            #  #                                              #   #                                    #
                                                            #              #             #                    #                                        #
                                                            ###############################################   ##########################################    
                                                                                                          #             #          #
                                                                                                          #                        #
                                                                                                          #          #             #
                                                                                                          ##########################    