
                                                        #
                                                       # #
                                                      #   #
                                                     ### ###
                                                    #       #
                                                   #         #
                                                  #           #
                                                 #             #
                                                ######## ########
                                               #                 #
                                              #                   #
                                             #                     #
                                            #                       #
                                           #                         #
                                          #                           #
                                         #                             #
                                        ################ ################
                                       #                                 #
                                      #                                   #
                                     #                                     #
                                    #                                       #
                                   #                                         #
                                  #                                           #
                                 #                                             #
                                #                                               #
                               ######################### #########################
                              #                                                   #
                             #                                                     #
                            #                                                       #
                           #                                                         #
                          #                                                           #
                         #                                                             #
                        #                                                               #
                       #                               # #                               #
                      #####################################################################    