                                                                                                                     
                                         
                                         #####################################################
                                         #                                                   #
                                         #                                                   #
                                         #                                                   #
                                         #                                                   #
                                         # ################################################# #                                                   
                                         #                      #      #                     #                          
                                         #                        #  #                       #              
                                         #                        #  #                       #            
                                         #                        #  #                       #         
                                         #                        #  #                       #             
                                         ##########################  #########################                              
                                         #                                                   #              
                                         #                           #########################                                
                                         #                                                   #           
                                         #                           #########################                                   
                                         #                                                   #         
                                         # ###################################################     
                                         #                                                   #          
                                         #        #        #          #                      #         
                                         #                                                   #          
                                         #                        #                          #        
                                         #                                                   #         
                                         ################################################### #        
                                         #  #          #                                 #   #
                                         #  #                #                               #                   
                                         #  #                    #                           #           
                                         #         #                                         #          
                                         #  #                      #                         #             
                                         #  #      #                                         #          
                                         #  #                   #                            #          
                                         #  #                                                #   
                                         # ###################################################       
                                         #  #                       #                        #                
                                         #  #                       #                      # #           
                                         #  #                       #                      # #          
                                         #  #                                              # #             
                                         #  #                       #                      # #          
                                         #  #                       #                      # #          
                                         #                          #                      # #   
                                         ################################################### #       
                                         #                                                 # #                
                                         #              #                                  # #           
                                         ######                           #                # #          
                                         #                                                ## #             
                                         ######              #                             # #          
                                         #                                  #              # #          
                                         #                                                   #   
                                         ######### ##################### #####################
                                                 # #                   # #                                   
                                                 # #                   # #           
                                                 ###                   ###                                       

                                               