
                                                         


                                     ####################################################
                                     #       #                                          #         
                                     #       #                                        # #         
                                     #       #     #      #                             #       
                                     #       #  #                 #           #         #          
                                     #       #   #                               ###  ###        
                                     #       #                        #           ##### ####         
                                     #                                            #        #     
                                     #       #              #                     #     ####       
                                     #       #      #     #        #  #           #     #            
                                     #       #                                 #  #     #          
                                     #       # #                                        #      
                                     #       #                                          #     
                                     ####################################################     

                                                                                                   