

########################################                                                                
#   #        #        #                # 
#                            #         #
##############################         #
                             #    #    #              
                             #         #            
                             #    #    #                       ####   
                             #         #                       #  #   
                             #         #                       #  #
                             # ####### #                  ######  ########
            ##################         ################## # #            #
            #                                           # # #            #                           
            #                                           # # #            #                                      
            ##################         #################### #     ##     ######                  
                             #         ###                                    #
                             #                                                #
                             #         ####################            ########                           
                             #         #                  #            #
                             #         #                  ##### ##  ####
                             #         #################      #     #         
                             #              #          #      #     #
                             #     #                   #      #     #
                             #   # #                   #      ####  #       
                             ########################  #         #  #      
                                                    #  #         #  #
                                                    ####         ####    