                                                     # #
                                                     # #
                                                     # #
                                                     # #
                                          ############ ###########
                                          #          # #         #
                                          #          # #         #
                                          #          # #         #
                                          #                      #
                                          #                      #
                                          #                      #
                                          #                      #
                                          #                      #
                                          #                      #
                                          #                      #
                                          #                      #
                                          #                      #
                                          #                      #
                                          #                      #
                                          #                      #
                                          #          # #         #
                                          #                      #
                                          #                      #
                                          #                      #
                                          #                      #
                                          #                      #
                                          #                      #
                                          #                      #
                                          #                      #
                                          #                      #
                                          #                      #
                                          #                      #
                                          #                      #
                                          #                      #
                                          #                      #
                                          #                      #
                                          #                      #
                                          ############ ###########  
                                                     #  #
                                                     ####             