
                                                             ########
                                                             #    # #
                                                             #      #
                   ######   ##############################   #    ###
                   #    #   #                            #   #      #
                   #    #   #                            #   #      #
                   #    #   #                            #   #      #
                   #    #   #                            #   #      #
                   #    #####                            #   #      #    
                   #                                     #####    # #
                   #                                                #
                   ###########################################      #
                                                             #      #
                                                             #      #
                                                             #      #
                                                             # #    #
                                                             #      #
                                                             #      #
                                                             #      #
                                                             #      #
                ##############################################      #
             ####                                     #             #
             #                                        #         #   #
             ####                                     #             #
                #                                                   #
                #                                     #             #
                #                                     #             # 
                #                                     #             #
                ####    #############################################
                   #     ##                                        
                   #      #
                   #    ###
                   #    #
                   #    #
                   ######  







