

                                                                                                                                          #####
                                                                                                                                          #   #
                                                                                                                  ######################### ###########   
                                                                                  #################################              #                    #
                                                                                ###                               #                                   # 
                                             ####################################                                 #              #                    #   
    ##########################################                            #                                       #              ###################### 
    #                                     #                               #                                       #              #
    #                                     #                               #                                       #              #
    #                                     #                               #                                       #              #
    ##                                    #                               #                                       #              #
     #                                    #                               #                                       #              #
     #                                    #                               #                                       #              #
     #                                    #                               #                                       #              #
     #                                    #                               #                                       #              # 
     ##############                       #                               #                                       #              #
                  ########## ######################### ######################## ###################################              # 
                  #                                                                    #                          #              #  
                  #                                                                    ############################## #################################################
                  #                                                                    #      #         #       #        #                                            #
                  #                                                                                             #        #                                            #
                  #                                                                    #      #         #       #        #                                            #
                  #                                                                    ############ ################# ####                                            # 
                  #                                                                    #      #             ##           #                                            #
                  ##########   ######################################### ######################             ##           #                                           ##
                           #   #                                     #                       #             ##           #                                            #
                           #   #                                     #                       #             ##           #                                            #
                           #   #                                     #                       #             ##           #                                            # 
                           #####                                     #                       #             ##           #                                            #
                                                                     #                       #             ##           #                                            #  
                                                                     #                       #             ##           #                                            # 
                                                                     #                       #             ##           #                                            #
                                                                     #                       #                                                                       #
                                                                     #                       #########################################################################   
                                                                     #                                                  #
                                                                     #####                                              #
                                                                     #                                                  #
                                                                     #                                                  # 
                                                                     #                                                  #
                                                                     #################################################### 





