



                         ###############################################################
            ##############                                                             ####### 
            #                                                                               # 
            #                                                                             ###
            #                                                                             #
            #                                                                             ##### 
            #                                                                                 #
            #                                                                                 #
        #############                                                                         # 
        #           #############                                                             #########
        #           #           #                                                             #       #
        #                       #                                                             #       #
        #           #                                                                         #       #
        #########################                                                                     #
                             #                                                                #########
                       #######                                                                   #
                    ####                                                                     #########################
        #############                                                                        #                       #
        #      #                                                                             #                       # 
        #      #                                                                             #                       # 
        #                                                                                    #                       #
        #      #                                                                             #                      ##
        ########                                                                             #                      #
               ################################################################## ############                      #
                                                                             #                                      ########    
                                                                             #                                      #      #
                                                                             #                                             #
                                                                             ###############################################     