



      ####                                      ############################################                                             ##########################
      #  #                                      #       #                          #       #                                             #                        #
      ####                                      #              #                 #         #                                             #                        # 
                                                #                           #              #                                             #                        ###
                                                ############################################                                             #                          # 
                                                                                                                                         #                          ######
                                                                                                              ########################   #                               # 
                                                                                                              #                      #   #################################
                                                                                                              #                      # 
                              #######                                                                         #                      #
                              #     #                                  #########                              #                      #
                              ##   ##                                  #       #                              #                      #
                              #     #                                  #########                              #                      #
                              #######                                                                         ########################      ###
                                                                                                                                            # #
           #######                                                                                                                          # #  
           #     #                                                                                                                          # # 
           ##   ##                                                                                                                          ###
           #     #                           ########################                                         #######               ###             #######
           #######                           #                      #                           ##########    #     #               # #             #     #
                                             #                      #                           #        #    #######               # #             #######
                                             #                      #                           ##########                          # # 
                                             #                      #                                                               ###
            ###########                      #                      #
            #T        #                      #                      #  
            ###########                      #                      #                       ###                                        ###############################
                                             #                      #                       # #                                        #                    #        # 
                                             ########################                       # #                                        #                    #        #
                                                                                            # #                                        #                             #
                                                                                            # #                                        #                    #        #
                                                                                            # #                                        ############################### 
                                                                                            # #
                                                                                            # #
                                                                                            # #           #####################         
                                                                                            # #           #                   #
                                                                                            ###           #                   #
                                                                                                          #                   #   
                                                                                                          #                   ####
                                                                                                          #                      #
                                                                                                          ########################   