
                                                                           
                                                                                                 
                                                                                                 
                                                                                                    
                                                                                                  
                                                                                            
                                                                                            ###########                     
                                                                           ##################         ##################
                                                                 ###########                                           ###########
                                                           #######                                                               #######
                                                     #######                                                                           #######
                                               #######                                                                                       #######
                                            ####                                                                                                    #### 
                                           #                                                                                                           #
                         ###################                                                                                                           #################                
                         #                                                                                                                                             #
                         #                                                                                                                                             #
                         #                                                                                                                                             # 
                         #                                                                                                                                             #
                         ##################                                                                                                             ################ 
                                          #                                                                                                             #
                                          #                                                                                                             # 
                                          #                                                                                                             #
                                          #                                                                                                             #
                                          #                                                                                                             #
                                          #                                                                                                             #
                                          #                                                                                                             # 
                                          #                                                                                                             #   
                                           #                                                                                                           #                          
                                           #                                                                                                           #                               
                                            ####                                                                                                   ####                         
                                               #######                                                                                       #######                                     
                                                     #######                                                                           #######                             
                                                           #######                                                               #######                                            
                                                                 ###########                                           ###########
                                                                           ##################         ##################                                                            
                                                                                            ###########
