                 ###
                 # # 
                 # #
                ## #
                #  #                ##########
                #  #                #        #  
                #  ##################        ###############
                #                                          ###########
                ########                                             #
                 #                                                   #
                 #                                                   #
                 #      ###### ###### ####### #            ###########
                 #      ###### ######         #            #
                 #      ###### ######         #            #
                 ####################         #            #                                                     ###
                        #######################            #                                                     # #                                  
                        #               #     #            #                                                     # # 
                        #    #                #            #                                    ################## ###
                        #                     #            #                          ###########                    #
                        #     #               #            #       ####################                              #
                        #                #                 #       #                                                 #
                        #                     #            #       #                                              ####    
                        ############ ##########            #       #                                                 #
                                   # #        #            #########                                                 #
                                   # #        #                    #                                                #######
                                   # #        #                    #                                                 #    #  
                                   ###        #                                                                      #    #
                                              #                    #                                                      #
                                              ########################################################################### #
                                                                                                                        ###   