


                              ##########################################################
                              #                                 #                      #               ####################################
                              #                                 #                      #               #                                  #
                              #                                 #                      #               #                                  #  
                              ####      ################  ########    ##################################                                  #
                              #           #                                                            ######                             # 
                              #                                                                             #                             #
                              #           #                                                            ######                             #
                              #############                                                            #                                  # 
                                          #                                                            #                                  # 
                                          #                                                                                               #
                                          #                                                                                               #
                                          #                                                                                               #
                                          #                                                            #                                  ######## 
                              #############                                                            #                                         #
                              #                                                                        #                                  #      # 
                              #           #                                                            #                                  #### ### 
                              #                                                                                                           #      #
                              ############################################################################                                #      #
                                                                                                         #                                #      #
                                                                                                         #                                       #
                                                                                                         #########################################