



                                                            ############
                                                            #          #
                                       ######################  #########                                   ###############################
                                       #                              ####                                 #                             #           ######
                                       #                                ###                                #                             #           #    #
                                       #                                  #                             ######@#######@#########@#######@####        #    #
                                       #                                  #                             ##                                  ############ ###################
                                       #                                  #                             #                                                                  # 
                                       #                                  #                             #                                   #                              #
                                       #                                  #                             #                                                                  #
                                       #####################             ##                             #                                   #                              # 
                                                           ####### #######                              #                                                                  #
                   #########################################             ################################                                   #######################   ######
                   #                                       #             #       #          #         #                                             #             #   #
                   #                #                                                                                                               #             #   # 
                   #                                       #             #       #          #         #                                             #             #   #
                   #                                       #             ############################################################################             #####
                   #    ###############################    ####### #######
                   #    #                             #    #             ##############
                   #    #                             #   ##                          ## 
                   ######                             #  ##                            ############  
                                                      # ##                                        ######## 
                                                      # #                                                ##
                                                   #### ##                                                ## 
                                                   #     #                                                 ##### 
                                                   #     #                                                 #   # 
                                                   #     #                                                     #  
                                                   #############################################################