
                                                         ####
                                                         #  # 
                                                       ###  ###
                                                       #     *#
                                                       #*    *# 
                          ################################  ##################################
                          #                                                                  # 
                          #                                                                  #
                          #                         #                     #                  #  
                          #                                                                  #
                          #           #                                                      #
                          #                                                                  # 
                          #                                   #                              #
                          #####            #                                #                #############
                          #   #                                                              #           #                          #####
                          #                                                                         ########################        # # #
                          ####################################################################      #                      #        # # #
                          #              #                                                   #      #                      ########## # # 
                          ################# ##################################################      #                      #            ###
                                         #                                                                                                #
                                   #######                                                  ##      #                      #            ###
                                   #         #                                               ############################################   
                                   ### ###                                                           #
                                   #     #                                                           #
                                   #     ########################################################## ##
                                   #                                                                 #
                                   ###################################################################   