



                    ###@                          ####                                                         #######
                    #                             #  #                                                         #     #
                    ################################ ############################################################# ###################
                                 #                                    #                              #                               #            
                                 #                                    #                              #                               ##################             
                                 #                                    #                              #                                               
          ######=================#                                    #                              #                                               
          #    #                 #                                    #                              #                                                   
          #    #                 #                                                                   #                               ##################        
          #  ###                 #                                    #                              #                               #                
          #  #                   #                                    #                              #                               #                ##   
          #  #                   #                                    #                              #                               #                 ##                 
          #  #                   ################################### ############################# ################## ################                  ###         
          #  #                   #                                    #                              #                               #                    ######    
          #  #                   #                                    #                              #                               #                         #
          #  #                   #                                 #  #                              #                               #                         # 
          #  #                   #                                    #                              #                               #                         #
          #  #                   #                                    #                              #                               #                         #
          #  #===================#                                    #                              #                               #                         # 
          #  #                   #                                    #                              #                               #                         # 
          #  #                   #                                    #                              #                               #                         #
          #  #                   #                                    #                              #                               #                         #
          #  #                   #                                    #                              #                               #                         #
          #  #                   ### ##################################### ######################################################## ##                         #
          #  #                   #                                    #                              #                               #                         #
          #  #                   #                                    #                              #                               #                         #
          #  #                   #                                    #                              #                               #                         #
          #  #                   #                                    #                              #                               #                         # 
          #  #                   #                                    #                              #                               #                         #
          #  #                   #                                    #                              #                               #                         #
          #  #                   #                                    #                              #                               #                         #
          #  #                   #####                                #                              #                               #                         #
          #  #                   #                                    #             ##               #                               #                         #
          #  #                   #                                    #             #                #                                                         #        
          #  #                   ############################################################################# ################################################# 
         ##  #####################                                                                           # #                             ##############
         #                                                                                                     #                              ############
         #                                                                                                     #                               ########## 
         #####################################################################################################################    
                                 ###########                             #######                                  ########### 
                                   #######                                 ###                                      #######

           