                             
               
                             ###                                                                               
                             # #                                                                   
                          #### #                     ###########                                          
                          #    #######################         #              ###                                           
                          #                                    #              # #
                          #                                    #     ###      # # 
                          ################            ##########     # #      # #                            
                                         #            #              # #      # #                         
                                         #          # #     ###      # #      # #                    
                                         #            #     # #      # #      # #                   
                   #######################            ####### ######## ######## #########
                   #       #                  #       ###                  #            #
                   #       #             # #           ##          #       #            ##########
                   #                     #       #      #                                        #
                   #       #                                       #                    ########## 
                   #################################################################### #                                                                              
                                                                            #           #               
                                                                            #           #              
                                                                            #           #                     
                                                                            ########### #
                                                                                #       # 
                                                                                #       #
                                                                                #       #
                                                                                ####### #
                                                                                      # #          
                                                                                      # #           
                                                                                      ###           