



                          ################################################
                          #                                             ###########
                          #                                                       #
                          #                                                       ##
                       ####                                                        ### 
                       #  #                                                          #
                       #  #                                                          #  
                       #                                                             ####   #########
                       ################                                              #  #   #       #
                                   #                                        #           #   #       #
                                   ######################################################   #       #
                                                                                            ### #####
                     ################################################################         # #      ###################################
                     #                                                              ########### ########                                 ### 
                     #                                                                                                                    ###  
                     ## ########                                                                                                            # 
                     #         #                                                                                                            ####
                     #        ##                                                                                                               # 
                     ##########                                                                                                                #
                              ########                                                                                                         #
                                     ######################################################################################################### #
                                                                                                                                             # #
                                                                                                                                             # # 
                                                                                                                                             ###            
                                                                         #########################################################
                                                                         #                                                       # 
                                                                         #                                                       #
                                                                         #                                                       #
                                                                         #                                                       # 
                                                                         #                                                       #
                                                                         ###################################################### ####### 
     #####                                                                    #                                                       #
     #   #                                                                    ############### ############ ############## ####### ##### 
     #####                                                                                  ###          ###            ###     # #
                                                                                                                                ###   